20,10
70
00,00
aaf0a1 19270d 25591f 98a353 72601b 593a0e
1111 2222 2222 2222 2222 2222 2222 2222 2222 2222 2222 2222 2222 2222 2222 1111 1111 3333 1111 1111
1111 2222 2111 1111 1111 1111 1111 1111 1111 1111 1111 1111 1111 1111 2222 1111 1111 3333 1111 1111
1111 2222 1111 1111 1111 1111 1111 5555 5555 5555 1111 1111 5555 1111 2222 1111 3333 3333 3333 1111
1111 2222 1111 4444 4444 1111 1111 5555 5555 5555 1111 1111 5511 1111 2222 1111 1111 3333 1111 1111
1111 2222 1111 4444 4444 1111 1111 1111 1111 1111 1111 1111 1111 1111 2222 1111 1111 3333 1111 1111
1111 2222 1111 4444 4444 4141 1111 1111 1111 1111 1111 1111 1111 1111 2222 1111 1111 3333 1111 1111
1111 2222 1111 4444 4444 1111 1111 6666 6666 6666 1111 1111 1166 1111 2222 2323 3333 3333 3333 1111
1111 2222 1111 1111 1111 1111 1111 6666 6666 6666 1111 1111 6666 1111 2222 1111 1111 3333 1111 1111
1111 2222 1121 1111 1111 1111 1111 1111 1111 1111 1111 1111 1111 1111 2222 1111 1111 3333 1111 1111
1111 2222 2222 2222 2222 2222 2222 2222 2222 2222 2222 2222 2222 2222 2222 1111 1111 3333 1111 1111
L1:04,06 L2:14,09 L3:14,00 L4:18,02
BG:12,06 RG:12,03 GG:15,06
BL:04,03 RL:07,06 GL:07,02
E1:01,00;RIGHT-COL2 E2:17,08;UP E3:00,09;UP
I1:17,00 I2:07,03 I3:18,06
NO:07,07