20,10
120
10,09
c2e1f0 76cbf5 5e7ba8 a5a7a8 d2d5d6 f0f1f2
1122 1111 3333 3333 3333 3333 3131 1111 6666 5555 5555 5555 5555 5555 5555 5555 5555 5555 5555 5555
3333 3333 3444 4444 4444 4443 3333 1111 6666 5555 5555 5555 5555 5555 5555 5555 5555 5555 5555 5555
2211 3311 3333 3333 3333 3333 1111 1111 6666 5555 5555 5555 5555 5555 5555 5555 5555 5555 5555 5555
1111 1111 3333 3333 3333 4141 1111 1111 6666 5555 5555 5555 5555 5555 5555 5555 5555 5555 5555 5555
1111 1111 1111 1111 1111 1111 1111 1111 6666 5555 5555 5555 5555 5555 5555 5555 5555 5555 5555 5555
6666 6666 6666 6666 6666 6666 6666 6666 6666 6666 6666 6666 6666 6666 6666 6666 6666 6666 6666 6565
1122 1111 3333 3333 3333 3333 3131 1122 6666 5555 5555 5555 5555 5555 5555 5555 5555 5555 5555 5555
5555 3333 3444 4444 4444 4443 3333 3333 6666 5555 5555 5555 5555 5555 5555 5555 5555 5555 5555 5555
2211 3311 3333 3333 3333 3333 1111 2211 6666 5555 5555 5555 5555 5555 5555 5555 5555 5555 5555 5555
6666 6666 6666 6666 6666 6666 6666 1166 6666 5555 5555 5555 5555 5555 5555 5555 5555 5555 5555 5555
E1:04,00;RIGHT-COL3 E2:00,09;UP E3:05,09;UP
L1:16,08 L1:03,02 L1:00,09 L1:04,03 L2:17,08 L3:18,08 L3:09,02 L4:16,09 L4:00,07 L1:09,00 L2:09,01 L4:09,03
I1:19,09 I1:00,01 I2:17,09 I2:02,03 I3:19,02 I3:19,07 I3:09,07 I3:06,00 I3:08,08
RG:02,09 RL:10,02 GL:11,02 BL:12,02 RL:13,08 GL:14,08 BL:15,08
RG:10,00 RG:10,01 GG:11,00 GG:11,01 BG:12,00 BG:12,01 RG:13,09 GG:14,09 BG:15,09 RG:19,00 GG:19,01 GG:19,06 RG:00,00
NO:18,09 NO:09,03