20,10
90
00,00
e6ad8c F3908F 70C2E2 a08ce6 8AF3E9 F897E6
6666 6666 6666 6666 6666 2222 6666 6666 6666 6666 6666 2222 6666 6666 6666 2222 6666 6666 6666 2222
6666 6666 2222 6666 6666 6666 6666 6666 2222 6666 6666 6666 6666 2222 6666 6666 6666 6666 6666 6666
5555 5555 5555 5555 5555 5555 5555 5555 5555 5555 5555 5555 5555 5555 5555 5555 5555 5555 2222 6666
1111 5555 5555 1111 5555 5555 5555 5555 5555 5555 2211 5555 3333 3333 3333 5555 2222 5555 6666 6666
5555 5555 5555 5555 5555 5555 5555 5555 5555 5555 5555 5555 3333 3333 3333 5555 5555 5555 6666 2222
1144 5555 5555 5555 5555 1111 5555 5555 1111 5555 5555 5555 5555 5555 3333 5555 5555 5555 6666 6666
4444 5555 5555 1111 5555 5555 5555 5555 5555 5555 5555 1111 3333 3333 3333 5555 5555 5555 2222 2626
4444 5555 5555 5555 5555 5555 5555 5555 1313 5555 5555 5555 3333 3333 5555 5555 5555 5555 5555 3333
4444 4444 4444 4444 4444 4444 5555 5555 5555 5555 5555 5555 5555 5555 5555 5555 5555 5555 5555 5555
4444 4444 4444 4444 4444 4444 4444 4444 4444 4141 1111 5555 5555 5555 5555 5555 2222 5555 2222 5555
I1:13,04
E2:09,01;UP E2:18,03;UP E2:01,06;UP
L1:07,01 L1:14,00 L1:16,03 L1:04,08 L3:19,07 L3:03,06 L4:11,06
GL:03,03 GG:14,05 GG:13,04
NO:12,04