20,10
75
00,00
F3908F 19270d 25591f 818c3c 72601b 593a0e
2222 2222 2222 2222 2222 2222 2222 2222 2222 2222 2222 2222 2222 2222 2222 2222 2222 2222 2222 2222
2222 3333 3333 3333 3333 3333 3333 3333 3333 3333 3333 3333 3333 3333 3333 3333 3333 3333 3322 2222
2222 3333 2233 2222 2222 2222 2222 2222 2222 2222 2222 2222 2222 2222 2222 2222 2222 2222 3333 2222
2222 3333 2222 4444 4444 2222 2222 2222 5555 5555 2222 2222 2222 6666 6666 2222 2222 2222 3333 2222
2222 3333 4444 4444 4444 4444 4455 5555 5555 5555 5555 2255 6666 6666 6666 6666 2233 3333 3333 2222
2222 3333 4444 4444 4444 4444 2244 5555 5555 5555 5555 5566 6666 6666 6666 6666 2222 2222 3333 2222
2222 3333 2222 4444 4444 2222 2222 2222 5555 5555 2222 2222 2222 6666 6666 2222 2222 2222 3333 2222
2222 3333 2222 2222 2222 2222 2222 2222 2222 2222 2222 2222 2222 2222 2222 2222 2222 2233 3333 2222
2222 3333 3333 3333 3333 3333 3333 3333 3333 3333 3333 3333 3333 3333 3333 3333 3333 3333 3333 2222
2222 2222 2222 2222 2222 2222 2222 2222 2222 2222 2222 2222 2222 2222 2222 2222 2222 2222 2222 2222
E1:13,00;RIGHT-COL2 E2:01,01;UP E3:17,09;UP
L1:04,03 L2:01,02 L3:09,09 L4:07,07
I1:17,04 I2:08,03 I3:03,03
RL:06,08 GL:11,01 BL:06,06
RG:06,01 RG:11,04 GG:06,05 GG:03,05 BG:16,04 BG:07,00
NO:10,00