20,10
85
09,09
c2e1f0 76cbf5 5e7ba8 a5a7a8 d2d5d6 f0f1f2
3333 3333 3333 3333 3333 3333 3333 3333 3333 4444 4444 3333 3333 3333 3333 3333 3333 3333 3333 3333
3333 3111 1111 1111 1111 1111 1111 1311 3333 4444 4444 3333 3111 1111 1111 1111 1111 1111 1311 3333
3333 1111 2222 2222 1122 2222 2222 1111 3333 4444 4444 3333 1111 6666 6662 1122 6626 6666 1111 3333
3333 1111 6666 6666 2222 6666 6666 1111 3333 4444 4444 3333 1111 2222 2222 2222 2222 2222 1111 3333
3333 1111 2222 6666 6666 6666 2222 1111 3333 3434 4343 3333 1111 2222 2226 2266 2262 2222 1115 5555
3333 1111 2626 6666 2222 2222 2222 1111 3333 3434 4343 3333 1111 2222 2626 6666 6262 2222 1511 5555
3333 1111 2222 6622 2222 2266 2222 1111 3333 4444 4444 3333 1111 2222 2622 6666 6222 2222 1111 3333
3333 1111 2222 2222 6666 6666 2222 1111 3333 4444 4444 3333 1111 2222 2222 6622 2222 2222 1111 3333
3333 1131 1111 1111 1111 1111 1111 1113 3333 4444 4444 3333 1131 1111 1111 1111 1111 1111 1113 3333
3333 3333 3333 3333 3333 3333 3333 3333 3333 4444 4444 3333 3333 3333 3333 3333 3333 3333 3333 3333
E1:01,02;DOWN-COL1 E2:15,00;UP E3:00,09;UP
L1:04,07 L2:06,03 L3:13,02 L4:17,02
I1:15,05 I2:19,05 I3:04,05 
RL:09,00 GL:02,03 BL:15,06
RG:04,02 GG:15,02 BG:18,04 BG:18,05
NO:19,04