20,10
85
00,00
e6ad8c F3908F 70C2E2 a08ce6 8AF3E9 F897E6
5552 4444 1166 1111 3333 3333 3333 3333 3131 4444 4444 1166 1111 3333 3333 3333 3333 3434 4545 5525
2222 2626 3333 3333 3666 6666 6666 6663 3333 4444 4444 3333 3333 3666 6666 6666 6663 3333 6262 2222
2222 2626 6611 3311 3333 3333 3333 3333 1111 4444 4444 6611 3311 3333 3333 3333 3333 1111 6262 2222
2222 4444 1111 1111 3333 3333 3333 1515 1111 4444 4444 1111 1111 3333 3333 3333 1515 1111 4444 2222
2424 4444 4444 4444 4444 4444 4444 4444 4444 4444 4444 4444 4444 4444 4444 4444 4444 4444 4444 4242
2424 4444 4444 4444 4444 4444 4444 4444 4444 4444 4444 4444 4444 4444 4444 4444 4444 4444 4444 4242
2222 4444 1166 1111 3333 3333 3333 3333 3131 4444 4444 1166 1111 3333 3333 3333 3333 3131 4444 2222
2222 2626 3333 3333 3666 6666 6666 6663 3333 4444 4444 3333 3333 3666 6666 6666 6663 3333 6262 2222
2222 2626 6611 3311 3333 3333 3333 3333 1111 4444 4444 6611 3311 3333 3333 3333 3333 1111 6262 2222
5255 4444 1111 1111 3333 3333 3333 1111 1111 5555 5555 1111 1111 3333 3333 3333 1111 1111 4444 2555 
E1:15,00;RIGHT-COL3 E1:06,00;RIGHT-COL3 E1:15,06;RIGHT-COL3 E1:06,06;RIGHT-COL3 E2:01,01;UP E2:18,08;UP E3:09,05;UP
L1:05,02 L2:05,08 L3:14,02 L4:14,08
I1:09,00 I1:10,00 I2:17,00 I3:05,01 I3:14,07
RL:12,04 GL:17,09 BL:09,08
RG:08,04 RG:08,05 RG:010,04 RG:09,04 GG:00,08 GG:19,08 GG:11,04 GG:11,05 BG:09,03 BG:10,03 BG:09,06 BG:10,06
NO:10,08