20,10
75
00,09
6d7178 b1b4b5 7d9fb0 636d83 96b0b5 b9e8f0
1111 1111 1111 1111 1111 1111 1111 1111 1111 1111 1111 1111 1111 1111 1111 1111 1111 1111 1111 1111
2222 2222 2222 2222 2222 1111 4444 4444 4444 4444 4444 4444 4444 4444 1144 4444 4444 4444 4444 1111
2222 2222 2222 2211 2222 1111 4444 3333 3355 3333 3333 3333 3333 3333 3333 3333 3333 3333 4444 1111
1111 1111 1111 1111 1111 1111 4444 3333 5555 5555 5555 5555 5555 5555 5555 5555 5555 5555 4444 1111
1111 2222 2222 2222 2222 2222 4343 3333 6666 6666 6666 6666 6666 6666 6666 6666 6666 5566 4444 1111
1111 2222 2222 2211 2222 2222 4444 3333 6666 6666 6655 6666 6666 6666 6666 6666 6666 6666 4444 1111
1111 1111 1111 1111 1111 1111 4444 3333 5555 5555 5555 5555 5555 5555 5555 5555 5555 5555 4444 1111
3333 3333 3131 1111 1111 1111 4444 3333 3333 3333 3333 3333 3333 3333 3333 3333 3333 3333 4444 1111
1111 1111 1111 1111 1111 1111 4444 4444 4444 4444 4444 4444 4444 4444 4411 4444 4444 4444 4444 1111
1111 1111 1111 1111 1111 1111 1111 1111 1111 1111 1111 1111 1111 1111 1111 1111 1111 1111 1111 1111
E1:05,03;DOWN-COL1 E2:01,05;UP E3:16,05;UP
L1:00,00 L2:07,09 L3:13,07 L4:07,06
I1:00,07 I2:19,07 I3:17,07
RL:07,02 GL:05,05
RG:01,07 GG:08,01
NO:05,06