20,10
90
00,09
c2e1f0 76cbf5 5e7ba8 a5a7a8 d2d5d6 f0f1f2
4441 4411 4414 4444 4444 4444 4444 4444 4444 4455 4444 4444 4444 4444 4444 4444 4444 4441 4411 4414
4141 1111 1111 1111 1111 1111 1111 1111 1111 5555 1111 1111 1111 1111 1111 1111 1111 1111 1111 1414
4144 1111 1222 2222 2222 2222 2222 2222 2222 5522 2222 2222 2222 2222 2222 2222 2222 2122 1111 1444
4444 1111 2222 1111 1111 2222 2222 2222 2244 6666 2244 2222 2222 2222 2222 1111 1111 1111 1111 4444
4444 1111 2222 1111 1414 4444 2626 6666 4444 6666 4444 6666 6262 2222 2222 1111 3333 3333 3333 3434
4444 1111 2222 1111 1111 2222 2222 2222 4422 6666 4422 2222 2222 2222 2222 1111 1111 1111 1111 4444
4444 1111 2222 2222 2222 2222 2222 2222 2222 2222 2222 2222 2222 2222 2222 2222 2222 2222 1111 4444
4441 1111 2212 2222 2222 2222 2222 2222 2222 2255 2222 2222 2222 2222 2222 2222 2222 2221 1111 4414
4141 1111 1111 1111 1111 1111 1111 1111 1111 5555 1111 1111 1111 1111 1111 1111 1111 1111 1111 1414
4144 1144 1444 4444 4444 4444 4444 4444 4444 5544 4444 4444 4444 4444 4444 4444 4444 4144 1144 1444
E1:15,04;RIGHT-COL1 E2:13,00;DOWN E2:04,09;UP E3:13,09;LEFT
L1:01,01 L2:18,01 L3:01,08 L4:18,08
I1:16,04 I2:09,03 I3:09,06 
RL:08,04 GL:03,04 BL:09,04
RG:06,04 RG:12,04 GG:17,08 GG:02,01 BG:18,04
NO:09,05